64 64 20 20
********************
*     p            *
*  ****      c     *
*           ****   *
*      c           *
*     **   c       *
*        **** c    *
*       c    **    *
*     *****      ***
*            **    *
*   *       **     *
*    *****         *
*         *    c   *
*   c         ******
*  **      **      *
*             *    *
*        **     *  *
*  **             **
*    *             *
********************