64 64 20 20
********************
*                  *
*         *        *
*       ***        *
*         *        *
*     *****        *
*                  *
*                  *
*                  *
*                  *
*   ******         *
*                  *
*         ******   *
*      p           *
*  ******  **      *
*             *    *
*        ********  *
*  **             **
*    *             *
********************