64 64 20 20
44444444444444444444
4        p         4
4         3        4
4       012        4
4      m m         4
4  3  01112        4
43                 4
4 3                4
4  3               4
4      m           4
4   011112         4
4                  4
4         011112   4
4   m  m   m       4
4  011112  02      4
4         m   3    4
4        01111112  4
4  02             34
4               m x4
44444444444444444444