64 64 20 20
44444444444444444444
4        p         4
4         3        4
4       812        4
4                  4
4  3  01112        4
43                 4
4 3                4
4  3               4
4                  4
4   011112         4
4                  4
4         011112   4
4                  4
4  011112  02      4
4             3    4
4        01111112  4
4  02             34
4    3            x4
33333333333333333333